1111111F111111111
101E10EEEE01110E1
111101E000E0E1001
1E0EE100000111101
10E1010E10E110001
1E1EE000000001001
1111E110000000EE1
1111E0101E00E0001
1110E010E01E01001
1101E1E00E1100001
111011010000EE001
1E100E1001E010101
1E1110011E000E001
11111EEE100000001
100E0E101E1100101
11100E00001EE0011
1111111P111111111