1111111F111111111
11EE0EEEE01110011
101001001E0EE1011
1EEE0100011110001
100EE0E1110100011
100E0010010E0E001
1EEE0010011110001
1EEE0001110011001
1E001EE1011001001
101EE1101E0010001
1EEE1001010101001
11011E11000E0E001
1E0E100E011110001
1011E10000010EE11
11EEE111010000001
10E10100011E01E01
1111111P111111111