1111111F111111111
110E1EEEE01E10101
110E001001E110001
1E0E1110E11000001
101001EE11E100001
1110EE1E110000001
101110100EE10E001
100E11E1E11000001
1EE1101E101000001
10001EE00E1101101
101110001001E0001
11E1E011E10000001
1001E01E00111E001
11EE1E11000010001
111E00EE010011001
1111EE0000E000011
1111111P111111111