1111111F111111111
1EE10EEEE10010111
11001EE00E1110001
10E00E1E100000001
110EEE00000010111
111EE1E1010000001
1100E01E01E100011
1E101E011000E1001
1011E00EE11000101
1011000E0EE110101
1111110E00E0E0001
11EE10100E1010001
10E11000000E11001
10010EEE010100101
10100EE10E0101101
1E11E1000E1010001
1111111P111111111