1111111F111111111
1E1010EEE0E111001
111E100E11E000001
101000000E0E1E001
110111EE00100E001
11EEE101000110001
101011E1E10E00001
111E100EE01010001
1EE00E01011100001
1110E01E0E0110001
1EEE0101100100011
1000001100011EE01
1EEE1100101100001
1E1E10E0111000001
1E01111100EE00001
1EEE0100011110001
1111111P111111111