1111111F111111111
1E1EE0EEE00001111
101E00E00E0010111
1E00EE10011010001
1E1EE011001100001
10E00EE1111001001
1101010EE011000E1
1EE0E001100110001
1101E0100E0010E01
10100EEE000001011
1E1E0E01111000001
1001EE011E1010001
1EEE1100110010001
10E000E1001E10011
100001EE000E01011
1EE1E100000001011
1111111P111111111