1111111F111111111
1E00E0EEE0E110011
1E1E100E110010001
111E11EE010000001
1E01111E010E00001
11111E1E0E0000001
101000100E00E0E11
11010E0EE00001011
1E0EE011100101001
1E00E1E0001100101
1E101E11E00010001
100EEE01110001011
10101EE011E010001
1E1EE111100000001
10E10E1E011100001
10E0E000000111001
1111111P111111111