1111111F111111111
1E1010EEE1E10E001
10E0EE00001010101
101E11EE100100001
1E1110E0000E01011
1E00E01010E110011
11E0111100EE00001
110100EE10110E001
1E0E00E0011111001
1EE10000E00011111
10011111E0E000001
11101EE0E10001001
101011E00010EE001
10110EEE101000001
111001E1E10E00001
100EE10001E000101
1111111P111111111