1111111F111111111
100EEEEEE10110011
1E00E0E0101010101
1E101001EE1010001
1EE1001E101100001
11E11EE1100000001
1E10100101E010001
1010E10001EE11001
1E1E00E1001110001
1E001010EE1000111
11EE0011E01100001
1EE000E0100101101
111E0E00010E11001
10E00E00E01010001
1011E000EE1011001
100E11000EE101101
1111111P111111111