1111111F111111111
1EE1E0EEE01001101
111EE0E1010100001
1E1EE011100001001
1E0011101E01E0001
1010010111E0EE001
10E0100010E0110E1
1E00111E010E10001
11E1E1110E0000001
1E0100E1011100E01
11E1E1E0011000001
1EEE1111010000001
1E110EE1101000001
1000001E001E00E01
1E00E00E010111101
10E111000E1100E01
1111111P111111111