1111111F111111111
1E0EE0EEE00000011
10011001E1E000011
11100EE1E00110001
10110E10E1E010001
1EEE1010000010101
1EEE1111100000001
10100E001E0E00101
1000E010E00111001
100E1000E0E101011
11E1100000E000E01
1110E11EE10000001
1EE1E111100000001
1E1EE101100010001
111E1001E1000E001
10100E000E10E1011
1111111P111111111