1111111F111111111
110E0EEEE1E000111
111E0E0E100100101
11011000011E00E01
1E101010E110E0001
1E11010000101EE01
10110110E10EE0001
1011101E0E001E001
1EEE1110000010101
100E100011E0E0101
1001101E1E10E0001
1010E0E00E1100111
1E1E101E000110001
10E010E00E1011101
1010100EEE0001011
1100010001E1100E1
1111111P111111111