1111111F111111111
1E111EEEE110E0001
11110E00E1E000101
1EE0E100101001001
110E1E00E01100101
10100EE01E0111001
1110EE1E011000001
1EEE0001000001101
1EE00E11110100001
1E0E0E11010100101
100E0E0E001101101
101EEE10100110001
111E10E010E000001
101111100E0E0E001
10E1111EE10000001
111E1000001E100E1
1111111P111111111