1111111F111111111
1E0E1EEEE10010101
10000001E0E11E001
1E110E0E000011011
1111E11EE00000001
11010E10101E0E001
10EEE111100010001
10E1E1E1110000001
10110E0E11E100001
1EE0E000100110011
1E0E11E1001010001
111000E0EE0111001
1E1100100001E10E1
1EE011E1011000001
1EE1E011000000101
1E0E0E00000101101
1111111P111111111