1111111F111111111
1000EEEEE1E000111
1EE10E00001100011
1E10E1E1010000101
11101EE1E10000001
1E0EE001111100001
1E110E0E101010001
1EE000E1011110001
110E1E10E01100001
100E00EE110011101
110EEE11000010101
111010E00E10E1001
10EEE110000101101
1E11EE00011100001
11EE0E01111000001
10101000000E000E1
1111111P111111111