1111111F111111111
11EE1EEEE00111001
1E1010010EE010001
1001EE00101E01011
11E001101EE100001
1E110EE1101000001
100100EE001101E11
1EEE0011010011001
1101001E0110EE001
111E011E100000001
101EEE11011000001
1EE11E10000011001
110EE100E01100101
1000E1100011100E1
101E0110E00100011
100E000001E0E1101
1111111P111111111