1111111F111111111
1000E0EEEEE101111
111EE0E0010101001
111000E0EE1110001
1E0E0011E01000011
100E11110EE100001
110E0EE1101100001
1100111E0000010E1
1EE0E000000101101
11EE111E010000001
1101E1E000E100001
1E0110E110E010001
101E01E1110000001
10EE1E01011100001
100EEE01011000111
11E1EE00010010011
1111111P111111111