1111111F111111111
10E0EEEEE11001111
1EEE1001011100001
11E1E101E10000001
1EE1E001000001011
11E10EE1010001001
1011000E1E1E10001
10111E10E0E010001
111EE0E1101000001
1011E0EE110100001
1001EEE0011110001
1000EE0E000010011
1E01EE10011000101
1EEE0010111000001
1EE0E000111110001
10E011000EE100001
1111111P111111111