1111111F111111111
1000E0EEE0E0E0101
1EEE0110110001001
11E11010E000E1001
1EE01010E01000101
11110EE1E00100001
1111EEE0110000001
1EE110110E1000001
11EEE001001001101
11E0010001010E101
1001E0E00E0000011
11E11E1E010000001
11EEE100110001001
101E1001EE1100001
1010E1010E110E001
1E1E0000001E11001
1111111P111111111