1111111F111111111
10E1E1EEE00E01001
100E0E111110E0001
1E1E011E001100001
111EE0E0011100001
110EE100E00000111
111E0011EE1000001
11EE0E10100100101
1001011E11000E0E1
1E011E11100000001
111001010E100E001
1101E1E01E1000001
1010101100E0E10E1
10E1E0100E1000111
1E1E00001000E1001
1E100E000E0100111
1111111P111111111