1111111F111111111
110010EEE110000E1
1E000EE0110011001
1EEE1110011000001
1EE0E101011000011
111100001E1E00001
1EEE1010111000001
100EE01E111100001
1100E011EE0010011
11E110010100E0001
1EE01111E10000001
11100EE0000E10111
1E1E1E00010011001
1E0E10E0011000101
10111110E000000E1
11110E0001EE00101
1111111P111111111