1111111F111111111
1EE100EEE01100E01
10E1E1100E1010001
110EEE00110001011
110E100011000EE11
1E001E00E10101011
1E1E011E110000001
1E01EE00010011101
1E1E011001E010001
1000100001E1000E1
11E1100E00E110001
1EE10E01100010001
1000E0E0E01010011
10E0001010E10E011
11E0EE01110100001
1EE101000E0001101
1111111P111111111