1111111F111111111
1EE1E0EEE00001101
111000EE01E010101
101110E11E00000E1
1EE1E100000000011
1EEE0101110001001
1EE100E0011101001
1111E1EE100000001
10E11EE0101010001
101EE1E1101000001
100E1E10010E11001
10E110E1101000001
1EE01100001011001
10EE0111E01001001
1E10000EE10000001
10E1EE00010001011
1111111P111111111