1111111F111111111
111010EEEE0E00011
101EEE01100001011
1001100110E00EE11
10EE0E00011110101
101E1EE1011000001
1E1010000100E0101
11000100000110EE1
1110EE101E0000011
1E1E0100011E01001
101EE1E1011000001
1101E0E10E0110001
11100E100EE110001
11EE11000E0010011
1001EE0E111100001
1E0E01000010E0001
1111111P111111111