1111111F111111111
1EE001EEEE1110001
10E1EE11000010101
1101EEE0010011001
1E01E10110100E001
1E11E0E1011000001
1E1E0010E01000001
111E0100010EE1001
10110EE0110100001
1E0010EE000110001
11E0EE10111000001
110110EE0E0010101
1E1EE101100100001
111001011E000E0E1
1E01EE11011000001
11EEE000011000101
1111111P111111111