1111111F111111111
10E010EEE01110E01
1EEE0011110100001
11011E1E1E0000001
10EEE111010001001
1E101E10E00101001
10101011001EEE001
11110100EE10E0001
1EE1E111100000001
1000E0E0E00110111
1E0E10E1100101001
1011101E01000E0E1
10E0101E00E101001
10E000110101EE101
1EE1E111010000001
10EEE100010010111
1111111P111111111