1111111F111111111
100EEEEEE11001011
1110000E01EE00101
100E010E0E0111011
11EE110E011000001
11100EEE101000101
10001E00100E0E011
11E1E1101E0000001
1E1EE100000010111
1E1101EE000010011
1EEE1010111000001
1E00E01E011101001
10110E100EE101001
110010001E1EE0001
1EE1000E001100011
1E0E110000110E011
1111111P111111111