1111111F111111111
10EEE0EEE11000011
11E10E10E00110001
101E0E000E0100111
1E10EE00011100001
1E1E100E001110001
10EE0000E01111101
1111EEE1000100001
100E0E0011011E001
10E010E0E10010111
10EEE011010110001
1E11E10E110000001
1E0E1E01111000001
1E1EE100111000001
1111E01E010000001
1E11100001E00E101
1111111P111111111