1111111F111111111
1EE0E0EEE11101001
1E11111000E00E001
1EE0E100000010001
110E1E1E010100001
1E010000001E10011
1E1EE000010100001
110E10E000E101011
1EE1E111010000001
1EE0E001101000001
1E010000E10E00111
100001EE01E110101
1E111E11E00000001
111100E01E0100001
111111000E00E00E1
11EE1000000011101
1111111P111111111