1111111F111111111
1E100EEEE10E11001
110E011EE00010001
10E000EE010100011
11E1EE10100100001
1EE1E100011010001
100E01E1E10011001
1011EE0011E100001
110101EE0101E0001
110E101EE11000001
111E1E011E0000001
101EE0E1111000001
1110E01E10010E001
1E0101010E101E001
1EE000101100110E1
1EEE0000011100011
1111111P111111111