1111111F111111111
11011EEEEEE110001
1100000EEE0101101
1EE0E001010000011
1E0E0E00000101001
1E01EE00101011001
1111E11E0000E0001
11E100E11100E0001
110001101E1000E01
1EE1E110011000001
1E1E1E00111000001
111E00111EE000001
1E0000EE010000011
1EE1E110110000001
1E1010000E01E1101
11E0110000E11E001
1111111P111111111