1111111F111111111
11E011EEEE0E10001
111000000EE101011
11E001E0E00011101
1011E1E0001E10001
10EE1E10000001111
11E10011E10000001
1E10EE00100110011
1101111E00000E001
11E011010E1000E01
10EEE001010110011
100000111E110E001
1EE000E0001011111
111EEE01101000001
101EE1010110000E1
10E1EE00000100101
1111111P111111111