1111111F111111111
1EEE11EEE11001001
100E10110EE010101
1EE100E1001101001
1EE0E101111000001
1E11E001E00000101
1E1E11E1100000001
110001E01110000E1
11E1EE11100000001
101E0000E11000101
111E0EE0100100001
11EE100110100E001
10E10E1E110100001
1110EE100E1010001
1E100E0E110101001
100E0100011011001
1111111P111111111