1111111F111111111
10100EEEE1E1E0001
1E0E01E0100101101
1E11111E0E0000001
1E11EE01001001001
1E00101E111E00001
1110E11100000EE01
110EE111E10000001
100E11EE111000001
1E1E100101E010001
1E101010001E0E101
1E1110001EE100001
100E0E0E010100101
10EE010E010111001
1011101E1E000E001
111011000E010EE01
1111111P111111111