1111111F111111111
101EEEEEE10010111
10E1E110E11000001
1EEE1111100000001
1EE0E010101110001
110E1E10E11000001
110010E101EE10001
101100E1E100E1001
10E11E00E10110001
1EE0E000101111001
11E1E10E001010001
1E10EE11000110001
11001111EE00E0001
1011EE11100000001
1011E00E1E1100001
11110E00011E00E01
1111111P111111111