1111111F111111111
1E10E0EEEE0001011
1E10001E10E000001
111EE0E0010001001
10E1E1E1100010001
11E0EE00100101101
1E1010E10E1001001
101EE0E1011100001
110100010EE1100E1
1E1E0001E11000011
1101E0EE001011001
100EE00E100010111
1E1100E0E11010001
1EEE0101111000001
1EEE0010011010101
11E100000011010E1
1111111P111111111