1111111F111111111
110101EEE0EE00001
10E01E01E00110101
111EEE10011000001
101111EE1E0000001
1101E01101E0E0001
1EEE1101011000001
1E0E010110E110001
1001101E11000E001
1E010E1E111000001
1111E1000E1E00001
1E1EE101100010001
1001011E010E0E101
110E0EE0001010111
111E11EE100000001
1EE0E100000001011
1111111P111111111