1111111F111111111
10EE0EEEE00001011
1EE1E101011000001
1E0000101100EE101
1E100E11110000001
1EE01E11100000101
1E010E0E110000011
1E0EE001000001111
111E01EE010100001
10EEE001110110001
11E111E0E00100001
100110E1011E00E01
10E11EE1100100001
1E0E1E10010101001
1100EE1E011100001
10E01E000E1001001
1111111P111111111