1111111F111111111
1E10EEEEE00100001
1011E0E1E11000001
10E1E01E110001001
1110E1E00110000E1
1EE1E000000001011
1E100E1010010E011
1000E101001E11001
1E01E111010000001
100E0E00E10100011
100E1111E100E0001
10000E01E0E000101
11E0001100E01E101
10E10E10111E00001
1011110001EEE0001
1101E0000E1100E01
1111111P111111111