1111111F111111111
1E001EEEE0E101011
11011E1E0100E0001
1E01011E1E1000001
1EE01E01000101101
100EEE11010000111
110E0EE1100000111
1000E01100010E0E1
1011EE00E11100001
100E1110E01E01001
11E101E1E01000001
1001000EE110E0111
10E1001E1E0000001
1010EEE1111000001
1EE1E001111000001
1E1E0E00010000011
1111111P111111111